21 40
4 4 4 4 4 4 4 4 4 4 4 4 4 4 4 4 4 4 4 4 4 4 4 4 4 4 4 4 4 4 4 4 4 4 4 4 4 4 4 4
4 68 68 4 68 68 4 68 68 4 68 68 4 68 68 4 68 68 4 68 68 4 12 12 4 68 68 4 68 68 4 68 68 4 68 68 4 12 12 4
4 68 68 68 68 68 68 68 68 68 68 68 68 68 68 68 68 68 68 68 68 68 68 68 68 68 68 68 68 68 68 68 68 68 68 68 68 68 68 12
4 68 68 68 68 68 68 68 68 68 68 68 68 68 68 68 68 68 68 68 68 68 68 68 68 68 68 68 68 68 68 68 68 68 68 68 68 68 68 12
4 68 68 4 68 68 4 68 68 4 68 68 4 68 68 4 68 68 4 68 68 4 68 68 4 68 68 4 68 68 4 68 68 4 68 68 4 12 12 4
4 68 68 4 4 4 4 4 4 4 4 4 4 4 4 4 4 4 4 4 4 4 68 68 4 4 4 4 4 4 4 4 4 4 4 4 4 4 4 4
4 68 68 4 68 68 4 68 68 4 68 68 4 68 68 4 68 68 4 68 68 4 68 68 4 68 68 4 68 68 4 68 68 4 68 68 4 12 12 4
4 68 68 68 68 68 68 68 68 68 68 68 68 68 68 68 68 68 4 68 68 68 68 68 68 68 68 68 68 68 4 68 68 68 68 68 68 68 68 12
4 68 68 68 68 68 68 68 68 68 68 68 68 68 68 68 68 68 4 68 68 68 68 68 68 68 68 68 68 68 4 68 68 68 68 68 68 68 68 12
4 68 68 4 68 68 4 68 68 4 68 68 4 68 68 4 68 68 4 68 68 4 68 68 4 68 68 4 68 68 4 68 68 4 68 68 4 12 12 4
64 68 68 4 4 4 4 4 4 4 4 4 4 4 4 4 68 68 4 4 4 4 68 68 4 4 4 4 68 68 4 4 4 4 4 4 4 4 4 4
4 68 68 4 68 68 4 68 68 4 68 68 4 68 68 4 68 68 4 68 68 4 68 68 4 68 68 4 68 68 4 68 68 4 68 68 4 12 12 4
4 68 68 68 68 68 68 68 68 68 68 68 68 68 68 4 68 68 68 68 68 68 68 68 68 68 68 4 68 68 68 68 68 68 68 68 68 68 68 12
4 68 68 68 68 68 68 68 68 68 68 68 68 68 68 4 68 68 68 68 68 68 68 68 68 68 68 4 68 68 68 68 68 68 68 68 68 68 68 12
4 68 68 4 68 68 4 68 68 4 68 68 4 68 68 4 68 68 4 68 68 4 68 68 4 68 68 4 68 68 4 68 68 4 68 68 4 12 12 4
4 68 68 4 4 4 4 4 4 4 4 4 4 4 4 4 4 4 4 4 4 4 68 68 4 4 4 4 4 4 4 4 4 4 4 4 4 4 4 4
4 68 68 4 68 68 4 68 68 4 68 68 4 68 68 4 68 68 4 68 68 4 68 68 4 68 68 4 68 68 4 68 68 4 68 68 4 12 12 4
4 68 68 68 68 68 68 68 68 68 68 68 68 68 68 68 68 68 68 68 68 68 68 68 68 68 68 68 68 68 68 68 68 68 68 68 68 68 68 12
4 68 68 68 68 68 68 68 68 68 68 68 68 68 68 68 68 68 68 68 68 68 68 68 68 68 68 68 68 68 68 68 68 68 68 68 68 68 68 12
4 68 68 4 68 68 4 68 68 4 68 68 4 68 68 4 68 68 4 68 68 4 12 12 4 68 68 4 68 68 4 68 68 4 68 68 4 12 12 4
4 4 4 4 4 4 4 4 4 4 4 4 4 4 4 4 4 4 4 4 4 4 4 4 4 4 4 4 4 4 4 4 4 4 4 4 4 4 4 4
