30 40
2 2 2 2 2 13 13 2 2 2 13 13 2 2 2 2 13 13 13 2 2 13 13 2 2 2 2 13 12 12 12 13 2 2 2 2 2 2 2 2
2 0 0 0 0 60 60 60 60 60 60 60 60 60 60 60 60 60 57 0 0 60 60 0 0 0 0 60 60 60 60 60 60 60 60 60 60 60 60 2
2 0 69 69 0 60 60 1 0 0 60 60 60 60 60 60 60 60 57 0 0 60 60 0 69 69 69 60 60 60 60 60 0 0 0 69 69 0 60 2
2 0 69 69 69 60 60 1 0 0 60 60 0 0 0 0 60 60 60 60 60 60 60 0 69 69 0 60 60 60 60 60 0 69 69 69 69 0 60 2
2 0 0 0 0 60 60 1 0 0 60 60 0 69 69 0 60 60 60 60 60 60 60 0 0 0 0 60 60 60 60 60 0 69 69 69 69 0 60 2
13 60 60 60 60 60 60 1 0 0 60 60 0 69 69 69 60 60 60 60 60 60 60 60 60 60 60 60 60 60 60 60 0 69 69 69 69 0 60 2
12 60 60 60 60 60 60 60 60 60 60 60 0 0 0 0 60 60 60 60 60 60 60 60 60 60 60 60 60 60 60 60 0 0 0 0 0 0 60 2
12 60 60 60 60 60 60 60 60 60 60 60 60 60 60 60 60 60 60 0 0 60 60 60 60 60 60 60 60 60 60 60 60 60 60 60 60 60 60 13
12 60 60 60 60 60 60 60 60 60 60 60 60 60 60 60 60 60 60 0 0 60 60 60 60 60 60 60 60 60 60 60 60 60 60 60 60 60 60 12
13 60 60 60 60 60 60 0 0 0 0 60 60 60 60 60 60 60 60 0 0 60 60 60 60 60 0 0 0 0 60 60 60 60 60 60 60 60 60 12
0 0 0 0 60 60 60 0 69 69 0 60 60 60 60 60 60 60 60 0 0 60 60 60 60 60 0 69 69 0 60 60 60 60 60 60 60 60 60 12
0 69 69 0 60 60 60 0 69 69 0 60 60 60 60 60 60 60 60 60 60 60 60 60 60 60 0 69 69 69 60 60 60 60 0 0 60 60 60 12
0 69 69 0 60 60 60 0 69 0 0 60 60 60 60 60 60 60 60 60 60 60 60 60 60 60 0 0 0 0 60 60 60 60 0 0 60 60 60 13
0 0 69 0 60 60 60 60 60 60 60 60 0 0 0 60 60 0 0 0 0 60 60 60 60 60 57 60 60 60 60 60 60 60 0 0 60 0 0 0
12 60 60 60 60 60 60 60 60 60 60 60 0 0 0 60 60 0 64 68 0 60 60 60 60 60 60 60 60 60 60 60 60 60 0 0 60 0 69 0
12 60 60 60 60 60 60 60 60 60 60 60 60 60 60 60 60 0 64 68 68 60 60 60 60 60 60 60 60 60 60 60 60 60 0 0 60 0 69 0
12 60 60 60 60 60 60 60 60 60 60 60 60 60 60 60 60 0 0 0 0 60 60 60 60 60 60 60 60 60 60 60 60 60 60 60 60 60 60 12
2 60 0 0 60 60 0 0 0 0 0 0 0 60 60 60 60 60 60 60 60 60 60 60 60 0 0 0 0 60 60 60 60 60 60 60 60 60 60 12
2 60 0 0 60 60 0 69 69 69 69 69 0 60 60 60 60 60 60 60 60 60 60 60 60 0 0 0 0 60 60 60 60 60 60 60 60 60 60 12
2 60 0 0 60 60 0 69 69 69 69 69 0 60 60 0 0 60 60 60 60 60 60 60 60 60 60 60 60 60 60 60 60 60 60 60 60 60 60 12
2 60 0 0 60 60 0 69 69 69 69 69 0 60 60 0 0 60 60 60 60 60 60 60 60 60 60 60 60 60 60 60 60 60 60 0 0 60 60 2
2 60 0 0 60 60 69 69 69 69 69 69 0 60 60 0 0 60 0 0 0 0 0 60 60 60 60 60 0 0 0 0 60 60 60 0 0 60 60 2
2 60 0 0 60 60 69 69 69 69 69 69 0 60 60 0 0 60 0 69 69 69 0 60 60 60 60 60 0 69 69 0 60 60 60 0 0 60 60 2
13 60 60 60 60 60 0 0 0 0 0 0 0 60 60 60 60 60 0 69 69 69 69 60 60 60 60 60 0 69 69 69 60 60 60 0 0 60 60 2
13 60 60 60 60 60 60 60 60 60 60 60 60 60 60 60 60 60 0 69 69 69 69 60 60 60 60 60 0 0 0 0 60 60 60 0 0 60 60 2
2 0 0 0 0 60 60 60 60 60 60 60 60 60 60 60 60 60 0 0 0 0 0 60 60 60 60 60 60 60 60 60 60 60 60 0 0 60 60 2
2 69 69 69 69 60 60 60 60 0 0 0 0 57 57 57 60 60 60 60 60 60 60 60 60 60 60 60 60 60 60 60 60 60 60 0 0 60 60 2
2 69 69 69 69 60 60 60 60 0 0 0 0 57 57 57 60 60 60 60 60 60 60 60 57 57 57 57 0 0 60 60 60 60 60 60 60 60 60 2
2 69 69 69 0 60 60 60 60 60 60 60 60 60 60 60 60 60 60 60 60 60 60 60 57 57 57 57 0 0 60 60 60 60 60 60 60 60 60 2
2 2 2 2 2 13 12 12 12 2 2 2 2 13 13 13 13 13 2 2 2 2 2 13 13 13 13 13 2 2 2 2 13 13 13 2 2 13 13 1
