30 40
9 9 9 9 9 9 9 9 9 9 9 9 9 9 9 9 9 9 9 9 9 9 9 9 9 9 65 9 9 9 9 9 9 9 9 9 9 9 9 9
9 9 9 9 9 9 9 9 9 9 9 9 9 9 9 9 9 9 9 9 9 9 9 9 9 69 69 69 9 9 9 9 9 9 9 9 9 9 9 9
9 17 9 17 9 17 9 17 9 17 9 17 9 17 9 17 9 17 9 17 9 17 9 17 9 69 69 69 9 17 9 17 9 17 9 17 9 17 9 9
9 17 9 17 9 17 9 17 9 17 9 17 9 17 9 17 9 17 9 17 9 17 9 17 9 9 69 9 9 17 9 17 9 17 9 17 9 17 9 9
9 17 17 17 17 17 17 17 17 17 17 17 17 17 17 17 17 17 17 17 17 17 17 17 17 17 17 17 17 17 17 17 17 17 17 17 17 17 17 13
9 5 5 68 68 17 17 17 17 17 17 17 17 17 17 17 17 68 68 5 5 5 5 9 9 9 17 8 8 8 8 8 8 8 8 8 8 8 17 9
9 5 5 68 68 68 17 17 17 17 17 17 17 17 17 17 68 68 5 5 5 5 17 9 9 9 17 8 8 8 8 8 8 8 8 8 8 8 17 9
9 5 5 5 68 68 68 68 17 17 17 17 17 17 17 68 68 5 5 5 5 68 17 9 9 9 17 8 8 8 8 8 8 8 8 8 8 8 17 9
9 17 5 5 5 5 68 68 68 68 68 68 68 68 68 68 5 5 5 5 68 68 17 9 9 9 17 17 17 17 17 17 17 17 17 17 17 17 17 13
13 17 17 17 5 5 5 5 68 68 68 68 68 68 68 5 5 5 5 68 68 68 17 9 9 9 17 9 9 9 9 9 9 9 9 9 9 9 17 9
9 16 16 16 68 68 5 5 5 5 68 68 68 68 5 5 5 5 68 68 68 68 17 9 9 9 17 9 9 9 9 9 9 9 9 9 9 9 17 9
13 16 16 16 16 68 68 68 5 5 5 68 68 5 5 5 68 68 68 68 68 68 17 9 9 9 17 9 9 9 9 9 9 9 9 9 9 9 17 9
9 16 16 16 16 68 68 68 68 68 68 68 68 68 68 68 68 68 68 68 68 68 17 16 16 16 17 9 17 17 17 17 17 17 17 17 17 17 17 13
13 16 16 16 16 68 68 5 5 68 68 68 68 68 68 68 5 5 68 68 68 68 17 10 10 10 17 9 17 9 9 9 9 9 9 9 9 9 9 9
9 17 17 17 68 68 68 5 5 68 68 68 68 68 68 68 5 5 68 68 68 68 17 10 10 10 17 9 17 9 9 9 9 9 9 9 9 9 9 9
13 17 17 17 68 68 68 68 68 68 68 5 68 68 68 68 68 68 68 68 68 68 17 9 8 10 17 9 17 9 9 9 9 9 9 9 9 9 9 9
9 17 17 17 68 68 68 68 68 68 68 5 68 68 68 68 68 68 68 68 68 17 17 10 9 10 17 9 17 17 17 17 17 17 17 17 17 17 17 13
13 17 17 17 68 68 68 68 68 68 68 5 68 68 68 68 68 68 68 68 68 17 17 10 8 10 17 9 9 9 9 9 9 9 9 9 9 9 17 9
9 17 17 17 68 68 68 68 68 68 5 5 68 68 68 68 68 68 68 68 68 17 17 10 8 10 17 9 9 9 9 9 9 9 9 9 9 9 17 9
13 17 17 17 68 68 68 68 68 5 5 5 68 68 68 68 68 68 68 5 68 17 17 10 10 10 17 9 9 9 9 9 9 9 9 9 9 9 17 9
9 17 17 68 68 68 68 68 5 5 5 5 68 68 68 68 68 68 68 5 68 17 17 16 16 16 17 9 17 17 17 17 17 17 17 17 17 17 17 13
13 17 17 68 68 68 68 68 68 68 68 68 68 68 68 68 68 68 5 5 68 17 17 8 8 8 17 9 17 9 9 9 9 9 9 9 9 9 9 9
9 17 68 68 68 68 68 68 68 68 68 68 68 68 68 68 68 68 5 68 68 17 17 8 8 8 17 9 17 9 9 9 9 9 9 9 9 9 9 9
13 17 68 68 68 5 5 68 68 68 68 68 68 68 68 68 68 5 5 68 68 68 17 8 8 8 17 9 17 9 9 9 9 9 9 9 9 9 9 9
9 17 68 68 68 68 5 5 68 68 68 68 68 68 68 68 5 5 68 68 68 68 17 8 8 8 17 9 17 17 17 17 17 17 17 17 17 17 17 13
13 17 17 68 68 68 68 5 5 5 5 5 5 5 5 5 5 68 68 68 68 17 17 9 8 8 17 9 9 9 9 9 9 9 9 9 9 9 17 9
9 17 17 17 68 68 68 68 68 68 68 68 68 68 68 68 68 68 68 68 17 17 17 8 8 8 17 9 9 9 9 9 9 9 9 9 9 9 17 9
13 17 17 17 17 68 68 68 68 68 68 68 68 68 68 68 68 68 68 17 17 17 17 8 8 8 17 9 9 9 9 9 9 9 9 9 9 9 17 9
9 17 17 17 17 17 17 17 17 17 17 17 17 17 17 17 17 17 17 17 17 17 17 16 16 16 17 17 17 17 17 17 17 17 17 17 17 17 17 13
9 9 9 9 9 9 9 9 9 9 9 9 9 9 9 9 9 9 9 9 9 9 9 9 9 9 9 9 9 9 9 9 9 9 9 9 9 9 9 9
