31 40
4 4 4 4 4 4 4 4 4 4 4 4 4 4 4 4 4 4 4 4 4 4 4 4 4 4 4 4 4 4 4 4 4 4 4 4 4 4 4 4
4 80 80 80 80 80 80 80 80 80 81 81 81 81 81 81 81 81 81 81 81 81 81 81 81 81 81 81 81 81 81 81 81 81 81 81 81 81 81 4
4 87 87 87 87 87 87 87 87 87 87 87 87 87 87 87 87 87 87 87 87 87 87 87 87 87 87 87 87 87 87 87 87 87 87 87 87 87 87 4
4 20 20 20 20 20 20 20 20 4 20 20 20 20 4 20 20 20 20 20 20 20 20 4 20 20 4 20 20 20 20 20 20 20 4 20 20 20 20 4
4 20 20 20 20 20 20 20 20 4 20 20 20 20 4 20 20 20 20 20 20 20 20 4 20 20 4 20 20 20 20 20 20 20 4 20 20 20 20 4
15 55 55 55 55 55 55 55 55 55 55 55 55 55 55 55 55 55 55 55 55 55 55 55 55 55 55 55 55 55 55 55 55 55 55 55 55 55 53 15
15 55 55 55 55 55 55 55 55 55 55 55 55 55 55 55 55 55 55 55 55 55 55 55 55 55 55 55 55 55 55 55 55 55 55 55 55 55 53 15
4 20 20 20 20 20 20 20 20 4 20 20 20 20 4 20 20 20 20 20 20 20 20 4 20 20 4 20 20 20 20 20 20 20 4 20 20 20 20 4
4 20 20 20 20 20 20 20 20 4 20 20 20 20 4 20 20 20 20 20 20 20 20 4 20 20 4 20 20 20 20 20 20 20 4 20 20 20 20 4
4 85 85 85 85 85 85 85 85 85 85 85 85 85 85 85 85 85 85 85 85 85 85 85 85 85 85 85 85 85 85 85 85 85 85 85 85 85 85 4
4 87 87 87 87 87 87 87 87 87 87 87 87 87 87 87 87 87 87 87 87 87 87 87 87 87 87 87 87 87 87 87 87 87 87 87 87 87 87 4
4 4 4 4 4 4 4 4 4 4 20 20 20 20 4 4 4 4 4 4 4 4 4 4 20 20 4 4 4 4 4 4 4 4 4 4 4 4 4 4
4 68 68 68 68 68 68 68 68 4 20 20 20 20 4 15 20 20 20 20 20 20 20 71 20 20 4 15 15 4 4 4 4 4 4 71 71 71 71 4
4 68 68 68 68 68 68 68 68 4 20 20 20 20 4 15 20 20 20 20 20 20 20 71 20 20 4 20 20 20 20 20 20 71 71 71 71 71 71 12
4 68 68 68 68 68 68 68 68 68 20 20 20 20 4 4 4 4 4 4 4 20 20 4 20 20 4 20 20 20 20 20 20 71 71 71 71 71 71 12
4 64 68 68 68 68 68 68 68 68 20 20 20 20 4 4 4 4 4 4 4 20 20 4 20 20 4 20 20 4 4 4 4 4 4 71 71 71 71 4
4 68 68 68 68 68 68 68 68 68 20 20 20 20 4 4 4 4 4 4 4 20 20 4 20 20 4 20 20 4 4 4 4 4 4 71 71 71 71 4
4 68 68 68 68 68 68 68 68 4 20 20 20 20 4 4 4 4 4 4 4 20 20 4 20 20 68 20 20 20 20 20 20 15 4 71 71 71 71 4
4 68 68 68 68 68 68 68 68 4 20 20 20 20 4 4 4 4 4 4 4 15 15 4 20 20 68 20 20 20 20 20 20 15 4 71 71 71 71 4
4 4 4 4 4 4 4 4 4 4 20 20 20 20 4 4 4 4 4 4 4 4 4 4 20 20 4 4 4 4 4 4 4 4 4 4 4 4 4 4
4 85 85 85 85 85 85 85 85 85 85 85 85 85 85 85 85 85 85 85 85 85 85 85 85 85 85 85 85 85 85 85 85 85 85 85 85 85 85 4
4 87 87 87 87 87 87 87 87 87 87 87 87 87 87 87 87 87 87 87 87 87 87 87 87 87 87 87 87 87 87 87 87 87 87 87 87 87 87 4
4 20 20 20 20 20 20 20 20 4 20 20 20 20 4 20 20 20 20 20 20 20 20 4 20 20 4 20 20 20 20 20 20 20 4 20 20 20 20 4
4 20 20 20 20 20 20 20 20 4 20 20 20 20 4 20 20 20 20 20 20 20 20 4 20 20 4 20 20 20 20 20 20 20 4 20 20 20 20 4
15 55 55 55 55 55 55 55 55 55 55 55 55 55 55 55 55 55 55 55 55 55 55 55 55 55 55 55 55 55 55 55 55 55 55 55 55 55 53 15
15 55 55 55 55 55 55 55 55 55 55 55 55 55 55 55 55 55 55 55 55 55 55 55 55 55 55 55 55 55 55 55 55 55 55 55 55 55 53 15
4 20 20 20 20 20 20 20 20 4 20 20 20 20 4 20 20 20 20 20 20 20 20 4 20 20 4 20 20 20 20 20 20 20 4 20 20 20 20 4
4 20 20 20 20 20 20 20 20 4 20 20 20 20 4 20 20 20 20 20 20 20 20 4 20 20 4 20 20 20 20 20 20 20 4 20 20 20 20 4
4 85 85 85 85 85 85 85 85 85 85 85 85 85 85 85 85 85 85 85 85 85 85 85 85 85 85 85 85 85 85 85 85 85 85 85 85 85 85 4
4 80 80 80 80 80 80 80 80 80 81 81 81 81 81 81 81 81 81 81 81 81 81 81 81 81 81 81 81 81 81 81 81 81 81 81 81 81 81 4
4 4 4 4 4 4 4 4 4 4 4 4 4 4 4 4 4 4 4 4 4 4 4 4 4 4 4 4 4 4 4 4 4 4 4 4 4 4 4 4
