29 40
9 9 9 9 13 9 9 9 13 9 9 9 13 9 9 9 13 9 9 9 13 9 9 9 13 9 9 9 13 9 9 9 13 9 9 8 8 65 65 65
9 17 16 16 16 17 16 16 16 16 16 16 16 17 16 16 16 16 16 16 16 16 16 16 16 16 16 16 16 16 16 16 16 16 16 8 8 69 69 69
9 16 17 16 16 16 16 16 16 16 16 16 17 16 16 17 16 16 16 16 17 16 16 17 16 16 16 16 17 16 16 16 17 16 16 8 8 69 69 69
9 17 16 17 16 16 17 16 16 17 16 16 16 16 16 16 16 17 16 16 16 16 16 16 16 16 16 16 16 16 16 16 17 16 16 8 8 69 69 69
13 16 16 16 17 16 16 16 16 16 16 16 16 9 16 16 16 16 16 16 9 16 16 16 16 16 9 16 16 17 16 17 16 9 16 8 8 69 69 69
9 16 16 16 9 16 16 16 9 16 16 9 16 16 16 16 16 16 16 16 16 16 16 9 16 16 16 16 16 16 16 16 16 16 16 69 69 69 69 69
9 16 17 16 16 16 16 16 16 16 16 16 16 16 16 9 16 16 16 9 16 16 16 16 16 16 16 16 16 9 16 16 9 16 16 69 69 69 69 69
9 16 16 16 16 16 16 9 16 16 9 16 16 16 16 16 16 16 16 16 16 16 9 16 16 16 16 16 16 16 16 16 16 16 16 8 8 8 8 8
13 17 16 16 9 16 16 16 16 16 16 16 16 16 16 16 16 16 16 16 16 16 16 16 16 16 9 16 16 16 16 16 16 9 16 8 8 8 8 8
9 16 16 16 16 16 16 9 16 16 16 9 16 16 16 9 16 16 9 16 16 16 16 16 9 16 16 16 16 9 16 16 16 16 16 16 16 16 16 13
9 16 16 16 9 16 16 16 16 16 16 16 16 16 16 16 16 16 16 16 16 9 16 16 16 16 16 16 16 16 16 16 9 16 16 16 17 16 17 9
9 16 17 16 16 16 16 16 16 16 9 16 16 9 16 16 16 16 16 16 16 16 16 16 16 16 9 16 16 16 16 16 16 16 17 17 17 16 16 9
13 16 16 16 16 16 9 16 16 16 16 16 16 16 16 16 16 9 16 16 16 16 16 9 16 16 16 16 16 9 16 16 16 16 16 16 16 16 16 9
9 16 16 16 16 16 16 16 16 16 16 9 16 16 9 16 16 16 16 16 9 16 16 16 16 16 16 16 16 16 16 16 9 16 16 16 17 17 16 13
9 16 16 17 16 16 16 16 9 16 16 16 16 16 16 16 16 16 16 16 16 16 16 16 16 16 16 16 16 9 16 16 16 16 16 17 17 17 16 9
9 16 16 17 16 16 16 16 16 16 16 9 16 16 16 16 9 16 16 16 9 16 16 9 16 16 9 16 16 16 16 16 16 16 16 17 16 17 16 9
13 16 17 16 16 16 9 16 16 16 16 16 16 9 16 16 16 16 16 16 16 16 16 16 16 16 16 16 16 16 9 16 16 16 16 17 16 17 16 9
9 16 16 16 16 16 16 16 16 16 16 16 16 16 16 16 9 16 16 16 16 16 16 16 16 16 16 16 16 16 16 16 16 9 16 16 16 17 17 13
9 17 16 17 16 16 16 16 9 16 16 16 9 16 16 16 16 16 16 16 9 16 16 9 16 16 16 9 16 16 9 16 16 16 16 16 16 17 17 9
9 16 16 16 16 16 16 16 16 16 16 16 16 16 16 9 16 16 16 16 16 16 16 16 16 16 16 16 16 16 16 16 16 16 16 17 17 17 16 9
13 16 16 16 9 16 16 16 16 16 16 16 9 16 16 16 16 16 16 16 16 16 16 16 16 16 9 16 9 16 16 9 16 16 16 16 17 17 17 9
9 16 17 16 16 16 16 16 16 9 16 16 16 16 16 16 9 16 9 16 16 9 16 17 16 16 16 16 16 16 16 16 16 16 16 16 17 17 16 13
9 16 17 17 16 16 9 16 16 16 16 16 16 9 16 16 16 16 16 16 16 16 16 16 9 16 16 16 9 16 16 16 16 16 9 16 16 17 16 9
9 16 16 17 16 16 16 16 16 16 16 16 16 16 16 16 16 16 9 16 16 9 16 16 16 16 16 16 16 16 16 17 16 16 16 16 16 17 16 9
13 17 16 16 16 16 9 16 16 16 9 16 16 16 16 16 9 16 16 16 16 16 16 16 9 16 16 16 16 16 16 16 9 16 16 16 16 16 16 9
9 16 16 17 17 16 16 16 16 16 16 16 9 16 16 16 16 16 16 16 16 16 16 16 16 16 16 16 17 16 16 16 16 16 16 16 16 16 16 13
9 17 17 17 16 16 16 16 17 16 16 16 16 16 16 17 16 16 16 17 16 16 17 16 16 17 16 16 16 16 16 17 17 16 16 17 16 16 17 9
9 17 17 17 16 17 16 16 16 16 16 16 16 16 16 16 16 16 16 16 16 16 16 16 16 16 16 16 16 16 16 17 17 16 16 16 16 16 16 9
9 9 9 9 13 9 9 9 13 9 9 9 13 9 9 9 13 9 9 9 13 9 9 9 13 9 9 9 13 9 9 9 13 9 9 9 13 9 9 9
