50 29
13 12 12 13 0 13 12 12 13 0 13 12 12 13 0 13 12 12 13 0 13 12 12 13 0 13 12 12 13
68 68 68 68 0 68 68 68 68 0 68 68 68 68 0 68 68 68 68 0 68 68 68 68 0 68 68 68 68
52 52 52 52 0 52 52 52 52 0 52 52 52 52 0 52 52 52 52 0 52 52 52 52 0 52 52 52 52
52 52 52 52 0 52 52 52 52 0 52 52 52 52 0 52 52 52 52 0 52 52 52 52 1 52 52 52 52
52 52 52 52 0 52 52 52 52 23 52 52 52 52 23 52 52 52 52 0 52 52 52 52 21 52 52 52 52
52 52 52 52 0 52 52 52 52 0 52 52 52 52 0 52 52 52 52 0 52 52 52 52 0 52 52 52 52
52 52 52 52 0 52 52 52 52 0 52 52 52 52 0 52 52 52 52 0 52 52 52 52 0 52 52 52 52
52 52 52 52 0 52 52 52 52 0 52 52 52 52 0 52 52 52 52 23 52 52 52 52 0 52 52 52 52
52 52 52 52 23 52 52 52 52 0 52 52 52 52 0 52 52 52 52 0 52 52 52 52 0 52 52 52 52
52 52 52 52 0 52 52 52 52 21 52 52 52 52 0 52 52 52 52 0 52 52 52 52 0 52 52 52 52
52 52 52 52 0 52 52 52 52 0 52 52 52 52 0 52 52 52 52 0 52 52 52 52 23 52 52 52 52
52 52 52 52 0 52 52 52 52 0 52 52 52 52 0 52 52 52 52 0 52 52 52 52 0 52 52 52 52
52 52 52 52 0 52 52 52 52 0 52 52 52 52 0 52 52 52 52 0 52 52 52 52 0 52 52 52 52
52 52 52 52 0 52 52 52 52 0 52 52 52 52 23 52 52 52 52 0 52 52 52 52 0 52 52 52 52
52 52 52 52 0 52 52 52 52 0 52 52 52 52 0 52 52 52 52 0 52 52 52 52 0 52 52 52 52
52 52 52 52 23 52 52 52 52 23 52 52 52 52 0 52 52 52 52 0 52 52 52 52 23 52 52 52 52
52 52 52 52 0 52 52 52 52 0 52 52 52 52 0 52 52 52 52 0 52 52 52 52 0 52 52 52 52
52 52 52 52 0 52 52 52 52 0 52 52 52 52 0 52 52 52 52 23 52 52 52 52 0 52 52 52 52
52 52 52 52 0 52 52 52 52 0 52 52 52 52 0 52 52 52 52 0 52 52 52 52 0 52 52 52 52
52 52 52 52 0 52 52 52 52 0 52 52 52 52 0 52 52 52 52 0 52 52 52 52 0 52 52 52 52
52 52 52 52 0 52 52 52 52 0 52 52 52 52 23 52 52 52 52 0 52 52 52 52 0 52 52 52 52
52 52 52 52 0 52 52 52 52 0 52 52 52 52 0 52 52 52 52 0 52 52 52 52 0 52 52 52 52
52 52 52 52 23 52 52 52 52 0 52 52 52 52 0 52 52 52 52 0 52 52 52 52 0 52 52 52 52
52 52 52 52 0 52 52 52 52 0 52 52 52 52 0 52 52 52 52 21 52 52 52 52 23 52 52 52 52
52 52 52 52 0 52 52 52 52 0 52 52 52 52 0 52 52 52 52 1 52 52 52 52 0 52 52 52 52
52 52 52 52 0 52 52 52 52 0 52 52 52 52 0 52 52 52 52 0 52 52 52 52 0 52 52 52 52
52 52 52 52 0 52 52 52 52 0 52 52 52 52 0 52 52 52 52 21 52 52 52 52 0 52 52 52 52
52 52 52 52 0 52 52 52 52 0 52 52 52 52 0 52 52 52 52 0 52 52 52 52 0 52 52 52 52
52 52 52 52 0 52 52 52 52 23 52 52 52 52 0 52 52 52 52 0 52 52 52 52 0 52 52 52 52
52 52 52 52 23 52 52 52 52 0 52 52 52 52 0 52 52 52 52 0 52 52 52 52 0 52 52 52 52
52 52 52 52 0 52 52 52 52 0 52 52 52 52 0 52 52 52 52 23 52 52 52 52 0 52 52 52 52
52 52 52 52 0 52 52 52 52 0 52 52 52 52 23 52 52 52 52 0 52 52 52 52 0 52 52 52 52
52 52 52 52 0 52 52 52 52 0 52 52 52 52 0 52 52 52 52 0 52 52 52 52 0 52 52 52 52
52 52 52 52 0 52 52 52 52 0 52 52 52 52 0 52 52 52 52 0 52 52 52 52 0 52 52 52 52
52 52 52 52 0 52 52 52 52 0 52 52 52 52 0 52 52 52 52 0 52 52 52 52 0 52 52 52 52
52 52 52 52 0 52 52 52 52 23 52 52 52 52 0 52 52 52 52 0 52 52 52 52 23 52 52 52 52
52 52 52 52 0 52 52 52 52 0 52 52 52 52 0 52 52 52 52 0 52 52 52 52 0 52 52 52 52
52 52 52 52 0 52 52 52 52 0 52 52 52 52 0 52 52 52 52 0 52 52 52 52 0 52 52 52 52
52 52 52 52 23 52 52 52 52 0 52 52 52 52 0 52 52 52 52 0 52 52 52 52 0 52 52 52 52
52 52 52 52 0 52 52 52 52 0 52 52 52 52 0 52 52 52 52 0 52 52 52 52 0 52 52 52 52
52 52 52 52 0 52 52 52 52 0 52 52 52 52 23 52 52 52 52 0 52 52 52 52 0 52 52 52 52
52 52 52 52 0 52 52 52 52 0 52 52 52 52 0 52 52 52 52 0 52 52 52 52 0 52 52 52 52
52 52 52 52 0 52 52 52 52 0 52 52 52 52 21 52 52 52 52 23 52 52 52 52 0 52 52 52 52
52 52 52 52 0 52 52 52 52 0 52 52 52 52 0 52 52 52 52 0 52 52 52 52 0 52 52 52 52
52 52 52 52 0 52 52 52 52 0 52 52 52 52 0 52 52 52 52 0 52 52 52 52 23 52 52 52 52
52 52 52 52 0 52 52 52 52 23 52 52 52 52 0 52 52 52 52 0 52 52 52 52 0 52 52 52 52
52 52 52 52 0 52 52 52 52 0 52 52 52 52 0 52 52 52 52 0 52 52 52 52 0 52 52 52 52
52 52 52 52 23 52 52 52 52 0 52 52 52 52 0 52 52 52 52 0 52 52 52 52 0 52 52 52 52
52 52 52 52 0 52 52 52 52 0 52 52 52 52 0 52 52 52 52 0 52 52 52 52 0 52 52 52 52
67 67 67 67 0 67 67 67 67 0 67 67 67 67 0 67 67 67 67 0 67 67 67 67 0 67 67 67 67
