40 40
4 12 13 1 1 1 1 1 1 1 1 1 13 12 12 12 13 1 1 1 1 1 1 1 13 12 12 12 13 1 1 1 1 1 1 1 1 13 12 4
12 80 80 80 80 80 80 80 80 80 80 80 80 80 80 80 80 80 80 80 80 80 80 80 80 80 80 80 80 80 80 80 80 80 80 80 80 80 80 12
13 80 80 80 80 80 80 80 80 80 80 80 80 80 80 80 80 80 80 80 80 80 80 80 80 80 80 80 80 80 80 80 80 80 80 80 80 80 80 13
1 80 80 80 80 80 80 80 80 80 80 80 80 80 80 80 80 80 80 80 80 80 80 80 80 80 80 80 80 80 80 80 80 80 80 80 80 80 80 1
1 80 80 80 80 80 80 80 80 80 80 80 80 80 80 80 80 80 80 80 80 80 80 80 80 80 80 80 80 80 80 80 80 80 80 80 80 80 80 1
1 80 80 80 80 80 80 80 80 80 80 80 80 80 80 80 80 80 80 80 80 80 80 80 80 80 80 80 80 80 80 80 80 80 80 80 80 80 80 1
1 80 80 80 80 80 80 80 80 80 80 80 80 80 80 80 80 80 80 80 80 80 80 80 80 80 80 80 80 80 80 80 80 80 80 80 80 80 80 1
1 81 80 80 80 80 80 80 80 80 80 80 80 80 80 80 80 80 80 80 80 80 80 80 80 80 80 80 80 80 80 80 80 80 80 80 80 80 80 1
1 81 80 80 80 80 80 80 80 80 80 80 80 80 80 80 80 80 80 80 80 80 80 80 80 80 80 80 80 80 80 80 80 80 80 80 80 80 80 1
1 81 80 80 80 80 80 80 80 80 80 80 80 80 80 80 80 80 80 80 80 80 80 80 80 80 80 80 80 80 80 80 80 80 80 80 80 80 80 1
1 81 80 80 80 80 80 80 80 80 80 80 80 80 80 80 80 80 80 80 80 80 80 80 80 80 80 80 80 80 80 80 80 80 80 80 80 80 80 1
1 80 80 80 80 80 80 80 80 80 80 80 80 80 80 80 80 80 80 80 80 80 80 80 80 80 80 80 80 80 80 80 80 80 80 80 80 80 80 1
13 80 80 80 80 80 80 80 80 80 80 80 80 80 80 80 80 80 80 80 80 80 80 80 80 80 80 80 80 80 80 80 80 80 80 80 80 80 80 13
12 80 80 80 80 80 80 80 80 80 80 80 80 80 80 80 80 80 80 80 80 80 80 80 80 80 80 80 80 80 80 80 80 80 80 80 80 80 80 12
12 80 80 80 80 80 80 80 80 80 80 80 80 80 5 81 5 5 5 5 5 5 5 5 5 5 5 80 80 80 80 80 80 80 80 80 80 80 80 12
12 80 80 80 80 80 80 80 80 80 80 80 80 80 5 80 87 87 87 87 87 87 87 87 87 80 81 80 80 80 80 80 80 80 80 80 80 80 80 12
13 80 80 80 80 80 80 80 80 80 80 80 80 80 5 86 4 4 4 4 4 4 4 24 4 81 5 80 80 80 80 80 80 80 80 80 80 80 80 13
1 80 80 80 80 80 80 80 80 80 80 80 80 80 5 86 24 24 24 24 24 24 24 24 4 84 5 80 80 80 80 80 80 80 80 80 80 80 80 1
1 80 80 80 80 80 80 80 80 80 80 80 80 80 5 86 4 24 25 25 25 25 25 24 4 84 5 80 80 80 80 80 80 80 80 80 80 80 80 1
1 80 80 80 80 80 80 80 80 80 80 80 80 80 5 86 4 24 25 69 69 69 25 24 4 84 5 80 80 80 80 80 80 80 80 80 80 80 80 1
1 80 80 80 80 80 80 80 80 80 80 80 80 80 5 86 4 24 25 69 65 69 25 24 4 84 5 80 80 80 80 80 80 80 80 80 80 80 80 1
1 80 80 80 80 80 80 80 80 80 80 80 80 80 5 86 4 24 25 69 69 69 25 24 4 84 5 80 80 80 80 80 80 80 80 80 80 80 80 1
1 80 80 80 80 80 80 80 80 80 80 80 80 80 5 86 4 24 25 25 25 25 25 24 4 84 5 80 80 80 80 80 80 80 80 80 80 80 80 1
1 80 80 80 80 80 80 80 80 80 80 80 80 80 5 86 4 24 24 24 24 24 24 24 24 84 5 80 80 80 80 80 80 80 80 80 80 80 80 1
13 80 80 80 80 80 80 80 80 80 80 80 80 80 5 86 4 24 4 4 4 4 4 4 4 84 5 80 80 80 80 80 80 80 80 80 80 80 80 13
12 80 80 80 80 80 80 80 80 80 80 80 80 80 81 80 85 85 85 85 85 85 85 85 85 80 5 80 80 80 80 80 80 80 80 80 80 80 80 12
12 80 80 80 80 80 80 80 80 80 80 80 80 80 5 5 5 5 5 5 5 5 5 5 5 81 5 80 80 80 80 80 80 80 80 80 80 80 80 12
12 80 80 80 80 80 80 80 80 80 80 80 80 80 80 80 80 80 80 80 80 80 80 80 80 80 80 80 80 80 80 80 80 80 80 80 80 80 80 12
13 80 80 80 80 80 80 80 80 80 80 80 80 80 80 80 80 80 80 80 80 80 80 80 80 80 80 80 80 80 80 80 80 80 80 80 80 80 80 13
1 80 80 80 80 80 80 80 80 80 80 80 80 80 80 80 80 80 80 80 80 80 80 80 80 80 80 80 80 80 80 80 80 80 80 80 80 80 80 1
1 80 80 80 80 80 80 80 80 80 80 80 80 80 80 80 80 80 80 80 80 80 80 80 80 80 80 80 80 80 80 80 80 80 80 80 80 80 80 1
1 80 80 80 80 80 80 80 80 80 80 80 80 80 80 80 80 80 80 80 80 80 80 80 80 80 80 80 80 80 80 80 80 80 80 80 80 80 80 1
1 80 80 80 80 80 80 80 80 80 80 80 80 80 80 80 80 80 80 80 80 80 80 80 80 80 80 80 80 80 80 80 80 80 80 80 80 80 80 1
1 80 80 80 80 80 80 80 80 80 80 80 80 80 80 80 80 80 80 80 80 80 80 80 80 80 80 80 80 80 80 80 80 80 80 80 80 80 80 1
1 80 80 80 80 80 80 80 80 80 80 80 80 80 80 80 80 80 80 80 80 80 80 80 80 80 80 80 80 80 80 80 80 80 80 80 80 80 80 1
1 80 80 80 80 80 80 80 80 80 80 80 80 80 80 80 80 80 80 80 80 80 80 80 80 80 80 80 80 80 80 80 80 80 80 80 80 80 80 1
1 80 80 80 80 80 80 80 80 80 80 80 80 80 80 80 80 80 80 80 80 80 80 80 80 80 80 80 80 80 80 80 80 80 80 80 80 80 80 1
13 80 80 80 80 80 80 80 80 80 80 80 80 80 80 80 80 80 80 80 80 80 80 80 80 80 80 80 80 80 80 80 80 80 80 80 80 80 80 13
12 80 80 80 80 80 80 80 80 80 80 80 80 80 80 80 80 80 80 80 80 80 80 80 80 80 80 80 80 80 80 80 80 80 80 80 80 80 80 12
4 12 13 1 1 1 1 1 1 1 1 1 13 12 12 12 13 1 1 1 1 1 1 1 13 12 12 12 13 1 1 1 1 1 1 1 1 13 12 4
